0 0,0 0,0 0,0 0,0 0,0 0,0 0,0 0,0 0,0 0,0 0,0 0,0 0,0 0,0 0,0 0,0 0,0 0,0 0,0 0
0 0,0 0,6 3,6 3,6 3,6 3,6 3,6 3,6 3,6 3,6 3,6 3,6 3,6 3,6 3,6 3,6 3,6 3,0 0,0 0
0 0,0 0,6 3,4 3,11 5,5 3,5 3,10 7,4 3,6 5,5 7,8 7,4 3,4 3,0 0,4 3,5 3,6 3,0 0,0 0
0 0,0 0,6 3,4 4,11 6,4 4,5 4,10 8,4 4,4 8,7 8,8 8,4 4,5 4,0 0,4 4,4 4,6 3,0 0,0 0
0 0,0 0,6 3,7 0,5 0,6 0,7 0,4 0,5 0,6 0,7 0,4 0,6 0,5 0,6 0,5 0,4 0,6 3,0 0,0 0
0 0,0 0,6 3, 7 0,5 0,4 0,7 0,4 0,5 0,6 0,7 0,4 0,6 0,5 0,7 0,5 0,4 0,6 3,0 0,0 0
0 0,0 0,6 3,7 0,5 0,6 0,7 0,4 0,5 0,6 0,7 0,4 0,6 0,5 0,4 0,5 0,4 0,6 3,0 0,0 0
0 0,0 0,6 3,7 0,5 0,6 0,7 0,4 0,5 0,6 0,7 0,4 0,6 0,5 0,7 0,5 0,4 0,5 0,6 3,0 0
0 0,0 0,6 3,7 0,5 0,6 0,7 0,4 0,5 0,6 0,7 0,4 0,6 0,5 0,4 0,5 0,4 0,6 0,6 3,0 0
0 0,0 0,6 3, 7 0,5 0,6 0,7 0,6 0,5 0,6 0,7 0,4 0,6 0,5 0,7 0,5 0,4 0,7 0,6 3,0 0
0 0,0 0,6 3,7 0,5 0,4 0,7 0,4 0,4 0,6 0,7 0,4 0,6 0,5 0,4 0,5 0,6 0,4 0,3 5,0 0
0 0,0 0,3 5,7 0,4 0,6 0,7 0,4 0,5 0,6 0,7 0,4 0,6 0,5 0,7 0,5 0,4 0,5 0,6 3,0 0
0 0,0 0,3 5,4 0,5 0,6 0,7 0,4 0,7 0,6 0,4 0,4 0,4 0,5 0,5 0,5 0,4 0,6 3,0 0,0 0
0 0,0 0,6 3,7 0,5 0,6 0,7 0,4 0,5 0,6 0,7 0,4 0,6 0,5 0,6 0,5 0,4 0,6 3,0 0,0 0
0 0,0 0,6 3,7 0,4 0,6 0,7 0,6 0,5 0,6 0,7 0,4 0,6 0,5 0,7 0,5 0,4 0,6 3,0 0,0 0
0 0,0 0,6 3,7 0,5 0,6 0,7 0,4 0,5 0,6 0,7 0,4 0,6 0,7 0,6 0,5 0,4 0,6 3,0 0,0 0
0 0,0 0,4 3,7 0,5 0,4 0,7 0,4 0,5 0,6 0,7 0,4 0,6 0,6 0,4 0,5 0,4 0,4 3,0 0,0 0
0 0,0 0,4 4,7 0,5 0,6 0,7 0,4 0,5 0,6 0,7 0,4 0,6 0,4 0,4 0,5 0,4 0,4 4,0 0,0 0
0 0,0 0,0 0,0 0,0 0,0 0,0 0,0 0,0 0,0 0,0 0,0 0,0 0,0 0,0 0,0 0,0 0,0 0,0 0,0 0
0 0,0 0,0 0,0 0,0 0,0 0,0 0,0 0,0 0,0 0,0 0,0 0,0 0,0 0,0 0,0 0,0 0,0 0,0 0,0 0